1111111111111111
1P00000000000001
1011111111111101
101000C000000101
1010101111111101
1010101E00000001
1010001C11111101
1011111111111011
1000000000000001
1111111111111111